+--+--+--+--+--+--+--+--+--+--+--+--+--+--+--+--+--+--+--+--+--+--+--+--+  +--+--+--+--+--+--+--+--+--+--+--+--+--+--+--+--+--+--+--+--+--+--+--+--+
|                                |              |        |                    |                                   |           |        |     |     |
+--+--+--+--+--+--+--+--+  +--+  +  +--+--+--+  +  +  +--+  +--+--+--+--+--+  +  +--+  +--+--+--+--+--+--+  +--+--+  +  +--+  +  +--+  +  +  +  +  +
|                       |     |  |  |     |     |  |        |     |           |  |     |     |           |  |        |     |  |     |  |  |     |  |
+  +--+--+--+--+--+--+  +--+--+  +  +  +  +  +--+  +--+--+--+  +  +  +--+--+--+  +  +--+  +  +  +--+--+  +--+  +--+--+--+  +  +--+  +  +  +--+--+  +
|                 |  |     |     |  |  |  |  |     |           |  |  |     |     |        |  |     |  |  |           |     |        |  |  |        |
+  +--+--+--+--+  +  +--+  +  +--+  +--+  +  +  +--+  +--+--+--+  +  +  +  +  +--+--+--+--+  +--+  +  +  +  +--+--+--+  +  +--+--+  +--+  +  +--+--+
|     |           |        |     |        |     |  |  |        |  |     |     |  |              |     |     |           |  |     |  |     |        |
+--+--+  +--+--+--+--+--+  +--+  +--+--+  +--+--+  +  +--+--+  +  +--+--+--+--+  +  +--+--+  +--+  +--+--+--+  +--+--+--+--+  +  +--+  +--+--+--+  +
|        |              |              |  |        |           |           |     |     |     |     |           |              |  |     |     |     |
+  +--+  +  +--+--+--+  +--+--+--+--+--+  +  +--+--+--+--+--+  +  +--+--+  +--+  +--+  +--+  +  +--+  +--+--+--+  +--+--+--+--+  +  +--+  +  +  +--+
|  |     |        |  |           |        |     |           |  |  |     |           |     |  |     |     |        |  |           |  |  |  |  |     |
+  +--+--+--+--+  +  +--+--+--+  +  +--+--+  +  +  +--+--+  +  +  +  +  +--+--+--+  +--+  +--+--+  +--+  +  +--+--+  +  +--+--+--+  +  +  +  +--+  +
|  |           |  |           |  |  |        |           |     |     |     |        |     |           |              |     |        |     |     |  |
+  +  +  +--+--+  +  +--+--+  +  +  +--+--+--+--+--+--+--+--+--+--+--+--+  +  +--+--+  +--+  +--+--+--+--+--+--+--+  +--+  +  +--+--+--+--+  +  +  +
|  |  |           |  |        |  |        |                             |  |  |        |     |  |     |           |     |                    |  |  |
+  +  +--+--+--+--+--+  +--+--+  +--+--+  +  +--+--+--+--+  +--+--+--+  +  +--+  +--+--+  +--+  +  +  +  +--+--+  +--+--+--+--+--+--+--+--+--+--+  +
|  |     |              |        |           |           |  |        |     |     |        |     |  |     |     |                                |  |
+  +--+  +  +--+--+--+  +  +--+--+  +--+--+--+  +--+--+  +--+  +--+  +--+--+  +--+  +--+--+  +  +  +--+--+  +  +--+--+--+--+--+--+--+--+--+--+  +  +
|        |  |        |  |           |           |     |        |           |     |  |        |  |  |        |     |                       |  |     |
+  +--+--+  +  +--+  +  +--+--+--+--+  +--+  +--+  +  +--+--+  +--+--+--+  +--+  +  +--+--+--+  +  +  +--+--+--+  +  +--+--+--+--+--+--+  +  +--+  +
|  |        |  |     |           |     |     |     |     |     |     |           |              |  |     |     |     |                    |     |  |
+  +  +--+--+  +  +--+--+--+--+--+  +--+--+--+  +--+--+  +--+--+  +  +--+--+--+--+  +--+--+--+--+  +--+  +--+  +--+--+  +--+--+--+  +--+--+  +  +  +
|  |           |           |     |  |        |     |  |        |  |  |     |     |  |              |  |        |  |     |        |  |     |  |     |
+  +--+--+--+--+  +--+--+  +  +  +  +  +--+  +--+  +  +--+--+  +  +  +  +  +  +  +  +  +--+--+--+  +  +--+--+  +  +  +--+  +--+  +--+  +  +--+--+  +
|     |        |        |  |  |     |  |     |     |  |        |  |  |  |  |  |     |        |        |           |           |     |  |  |     |  |
+--+  +  +--+  +--+--+--+  +  +--+--+  +  +  +  +--+  +  +--+--+  +  +  +  +  +--+--+--+--+  +--+--+--+  +--+--+--+--+--+--+--+--+  +  +  +  +  +--+
|        |                 |  |        |  |  |  |     |     |     |  |  |     |              |     |     |  |                    |  |  |     |     |
+--+--+--+--+--+--+--+--+--+  +  +--+--+  +--+  +  +--+--+  +  +--+  +  +--+--+  +--+--+--+--+  +  +  +--+  +  +--+--+--+--+--+  +  +  +--+--+--+  +
|                    |     |     |        |     |  |        |     |  |  |        |     |        |  |        |        |              |        |     |
+  +--+--+--+--+--+  +  +  +--+--+  +--+  +  +--+  +  +--+--+--+  +  +  +  +--+--+  +  +  +--+--+  +--+--+  +--+--+  +  +--+--+--+--+--+--+  +  +--+
|        |              |           |     |  |     |           |  |     |     |     |     |  |           |  |  |     |  |     |        |     |     |
+  +--+  +--+  +--+--+--+--+--+--+  +--+--+  +--+  +--+--+  +--+  +--+--+--+  +  +--+--+--+  +  +--+  +--+  +  +  +--+  +--+  +  +  +--+  +--+--+  +
|  |  |     |  |        |     |     |        |     |        |     |  |        |  |           |     |  |     |  |     |        |  |  |     |        |
+  +  +--+  +--+  +--+  +  +--+  +--+  +--+--+  +  +  +--+--+  +--+  +  +--+--+  +  +--+--+--+  +  +--+  +--+  +--+  +--+--+  +  +  +  +--+  +--+--+
|     |     |     |     |           |  |        |  |                 |              |        |  |     |     |     |     |     |  |  |     |  |     |
+--+  +  +--+  +--+  +--+--+--+--+--+  +--+  +--+--+--+--+--+--+--+--+--+--+--+--+--+  +--+  +--+  +  +--+  +  +--+--+  +--+--+  +  +--+  +  +  +  +
|     |     |     |        |                 |        |                                |        |  |           |        |        |        |     |  |
+--+--+--+  +--+  +--+--+  +  +--+--+--+--+--+  +--+  +  +--+  +--+--+--+--+  +--+--+--+--+--+  +  +--+--+--+--+  +--+  +  +--+--+--+--+--+--+--+  +
|              |  |     |  |  |        |        |        |     |           |  |     |        |  |        |        |     |  |                       |
+  +--+--+--+--+  +  +  +  +  +--+--+  +  +--+--+--+--+--+--+  +  +--+--+  +--+  +  +  +--+  +  +--+--+--+  +--+--+  +--+  +  +--+--+--+--+--+--+  +
|           |     |  |  |              |  |           |     |  |  |     |  |     |        |  |           |        |     |  |  |        |           |
+  +--+--+  +  +--+  +  +--+--+  +--+--+  +  +--+--+  +  +  +--+  +--+  +  +  +--+--+  +--+  +--+--+--+  +--+--+  +--+  +  +  +  +--+  +  +--+--+--+
|  |     |  |  |  |  |        |  |        |  |     |     |              |     |     |  |     |        |  |        |     |  |     |     |           |
+  +--+  +  +  +  +  +--+--+  +--+  +  +--+  +--+  +--+--+--+--+--+--+--+--+--+  +  +--+  +--+--+  +--+  +  +--+--+--+--+  +--+--+  +--+--+--+--+  +
|     |  |  |  |  |  |     |        |  |                 |                       |     |  |     |           |     |     |        |     |           |
+--+  +  +  +  +  +  +  +--+--+  +--+--+  +--+--+--+  +--+  +  +--+--+--+--+--+--+--+  +  +  +  +--+--+  +--+  +  +  +  +  +--+--+--+  +  +--+--+--+
|  |     |  |  |  |  |        |  |        |     |     |     |  |                 |        |  |        |  |     |     |     |           |     |     |
+  +--+  +  +  +  +  +  +--+  +  +  +--+--+  +  +--+--+  +--+--+  +--+--+--+--+  +  +--+--+  +--+--+  +  +  +--+--+--+--+--+  +--+--+--+--+--+  +  +
|        |  |  |  |  |     |     |     |     |           |     |  |     |     |  |  |        |        |  |     |  |           |                 |  |
+--+--+--+  +  +  +  +--+--+  +--+--+  +  +--+--+--+--+--+  +  +  +--+  +  +  +  +--+  +--+--+  +--+--+  +--+  +  +  +--+  +--+  +--+--+--+--+--+  +
|           |  |  |        |     |     |  |           |     |  |        |  |     |           |  |     |     |  |  |  |     |     |           |  |  |
+  +--+  +--+  +  +--+--+  +--+--+  +--+  +  +--+--+  +  +--+  +--+--+  +  +--+--+  +--+--+--+  +  +  +--+--+  +  +  +  +--+  +--+  +  +--+  +  +  +
|     |  |     |     |     |           |  |     |     |  |     |        |              |     |     |     |     |  |  |  |     |  |  |  |        |  |
+  +  +--+  +--+  +--+  +--+  +--+--+--+  +--+  +  +--+  +  +--+  +--+--+--+--+--+--+  +  +  +--+--+--+  +  +--+  +  +--+  +--+  +  +  +--+--+--+  +
|  |     |        |     |     |     |        |  |     |  |  |     |  |              |  |  |           |           |     |     |     |           |  |
+  +--+  +--+--+  +  +  +  +--+  +  +  +--+--+  +--+  +  +  +  +--+  +  +--+--+--+  +--+  +--+--+--+  +--+--+--+--+--+  +--+  +--+--+--+--+--+  +  +
|  |        |     |  |  |     |  |     |        |     |  |           |  |              |  |                                |              |     |  |
+--+  +--+--+  +--+  +--+--+  +  +--+--+  +--+--+  +--+  +--+--+--+--+  +--+--+--+--+  +  +--+--+--+--+--+--+--+--+--+--+  +--+--+--+--+  +  +--+  +
|     |     |  |  |           |           |        |     |              |        |  |  |                             |        |        |     |     |
+  +--+  +  +  +  +--+--+--+--+--+--+--+--+  +--+  +  +--+  +--+--+--+--+  +--+  +  +  +--+--+--+--+--+--+--+--+--+  +--+--+--+  +--+  +--+  +  +--+
|  |     |  |  |     |              |        |     |  |     |                 |  |                       |           |        |  |        |  |     |
+  +  +--+  +  +  +--+  +--+--+--+  +  +--+--+--+--+  +  +--+  +--+--+--+--+--+  +--+--+--+--+--+--+--+  +  +--+--+  +  +--+  +  +  +--+--+  +--+  +
|        |     |     |        |  |     |              |     |     |              |        |        |        |     |  |  |  |     |  |        |     |
+  +--+--+--+  +--+  +--+--+  +  +--+  +  +--+--+--+--+--+  +  +--+  +--+--+--+--+  +--+  +  +--+  +--+  +--+  +  +--+  +  +--+--+  +  +--+--+  +--+
|     |     |           |     |        |  |                 |  |     |                 |  |  |  |     |  |     |  |     |        |           |     |
+--+--+  +  +--+--+--+  +  +--+--+--+--+  +  +--+--+--+--+--+  +  +--+  +--+--+--+  +--+  +  +  +--+  +--+  +--+  +  +--+  +--+--+--+--+--+--+--+  +
|        |           |  |  |              |                 |  |  |     |        |  |     |  |  |     |        |  |  |              |              |
+  +--+--+  +--+--+  +  +  +  +--+--+--+--+--+--+--+--+--+  +  +  +  +--+  +--+  +--+  +  +  +  +  +--+  +--+--+  +  +--+  +--+--+  +  +--+--+--+--+
|        |  |     |  |  |        |           |           |  |  |     |  |     |     |  |  |     |           |     |     |  |        |              |
+  +--+  +--+  +  +  +--+--+--+  +--+  +--+  +--+--+  +--+  +  +--+--+  +--+  +--+  +  +--+  +--+--+--+--+  +  +--+--+  +  +  +--+--+--+--+--+--+  +
|  |  |        |  |           |        |              |     |  |           |     |  |  |     |           |  |        |  |  |                 |     |
+  +  +--+--+--+  +--+--+--+  +--+--+--+--+--+--+--+--+  +--+  +--+--+--+  +--+  +  +  +  +--+  +--+--+  +--+--+--+  +  +--+  +--+--+--+--+  +  +  +
|              |     |                    |           |           |        |     |     |  |  |        |        |     |     |  |     |        |  |  |
+--+--+--+--+--+--+  +--+--+--+  +--+--+  +  +--+--+  +--+--+--+  +  +--+--+  +--+--+--+  +  +--+--+  +--+--+  +  +--+--+  +  +--+  +  +--+--+  +  +
|                    |     |     |     |     |              |        |        |     |     |        |     |     |        |  |        |     |     |  |
+  +--+--+--+--+--+  +  +  +--+--+  +  +--+--+--+--+--+--+  +--+--+--+  +--+--+  +  +  +--+--+--+  +--+  +--+  +--+--+  +  +--+--+  +--+  +  +--+  +
|              |     |  |  |        |           |        |     |        |        |     |              |     |           |        |     |  |     |  |
+  +--+--+--+  +  +--+  +  +  +--+--+--+--+--+  +  +--+  +--+  +  +--+--+  +--+--+--+--+  +  +--+--+--+--+  +--+--+--+--+--+--+  +--+--+  +--+  +  +
|  |           |  |     |  |  |              |        |     |     |        |           |  |              |  |                 |           |  |  |  |
+  +  +--+--+--+--+  +--+  +  +--+  +--+--+--+--+--+  +--+  +--+--+  +--+--+--+--+  +--+  +--+--+--+--+  +  +  +--+--+--+--+  +--+--+--+  +  +  +--+
|  |     |     |     |     |     |  |     |     |        |     |     |              |     |  |           |     |           |  |              |     |
+  +--+  +  +  +  +--+  +--+--+  +  +  +  +  +  +--+--+--+--+  +  +--+--+--+  +--+--+  +--+  +  +--+--+--+--+--+  +--+  +--+  +  +--+--+--+--+--+  +
|     |     |     |     |        |  |  |     |     |           |           |           |     |        |              |     |  |  |     |           |
+--+--+--+--+--+--+  +--+  +--+--+  +  +--+--+--+  +  +--+--+  +--+--+--+  +  +--+--+--+--+  +--+--+  +  +--+--+--+--+--+  +  +  +--+  +  +--+--+  +
|                    |     |        |  |        |     |              |  |  |        |        |     |  |  |        |        |  |     |  |  |  |     |
+  +--+--+--+--+--+--+  +--+  +  +  +  +  +--+  +--+  +--+--+--+--+  +  +  +--+--+  +  +--+--+  +  +  +  +--+--+  +  +--+--+  +--+  +  +  +  +  +--+
|        |        |     |     |  |  |  |     |     |  |           |     |     |        |        |     |           |     |        |     |  |  |  |  |
+  +--+  +  +--+  +  +--+--+--+  +  +  +--+  +--+  +--+  +--+--+  +--+  +--+  +--+--+--+  +--+--+--+--+  +--+--+--+--+  +  +--+--+  +--+  +  +  +  +
|  |     |  |  |                 |  |     |  |  |     |        |     |     |     |        |              |              |           |     |        |
+  +  +--+  +  +--+--+--+--+--+--+--+--+  +  +  +--+  +  +--+--+--+  +--+  +--+  +  +--+  +  +--+--+--+--+  +--+--+--+--+--+  +--+--+  +--+--+--+--+
|  |        |  |              |           |        |     |        |     |  |     |     |  |  |              |        |     |     |     |           |
+  +--+--+--+  +  +--+--+--+  +  +--+--+  +--+--+  +--+--+  +--+  +--+  +  +  +--+  +  +--+  +  +--+--+--+  +  +--+  +  +  +--+--+  +--+  +--+--+  +
|              |        |     |     |     |     |        |     |        |  |  |  |  |        |     |     |  |     |     |        |  |     |        |
+--+--+--+  +--+--+--+  +  +--+--+  +  +--+--+  +  +--+--+--+  +--+--+  +--+  +  +  +--+--+--+--+  +  +  +--+--+  +--+--+--+--+  +  +  +--+  +--+  +
|           |           |           |           |  |           |     |  |     |           |        |  |           |        |     |     |     |     |
+  +--+--+--+  +--+--+--+--+--+--+--+--+--+--+--+  +  +--+--+  +  +  +--+  +--+--+--+--+--+  +--+  +  +--+--+--+--+  +--+  +--+  +--+--+  +--+--+--+
|  |        |        |     |              |        |     |     |  |                 |     |     |  |                    |     |        |           |
+  +--+  +  +--+--+  +  +  +  +--+--+--+  +  +--+--+--+  +--+--+  +--+--+--+--+--+  +  +  +--+  +  +--+--+--+--+--+--+--+--+  +--+--+  +--+  +--+  +
|     |  |        |     |  |     |        |        |  |  |     |  |  |           |     |        |        |     |     |     |     |  |     |     |  |
+--+  +--+--+--+  +--+--+  +--+  +  +--+--+--+--+  +  +  +  +  +  +  +  +--+--+  +--+--+--+--+--+--+--+--+  +  +  +  +  +  +--+  +  +--+  +--+--+  +
|                       |        |                    |     |        |     |                                |     |     |        |                 |
+--+--+--+--+--+--+--+--+--+--+--+--+--+--+--+--+--+--+--+--+--+--+--+--+  +--+--+--+--+--+--+--+--+--+--+--+--+--+--+--+--+--+--+--+--+--+--+--+--+
